"filename", "language", "C++", "C", "comment", "blank", "total"
"/home/eli/Stakken/src/Entry.cpp", "C++", 116, 0, 9, 50, 175
"/home/eli/Stakken/src/Entry.h", "C++", 10, 0, 1, 7, 18
"/home/eli/Stakken/src/Gameplay/Board.cpp", "C++", 106, 0, 14, 36, 156
"/home/eli/Stakken/src/Gameplay/Board.h", "C++", 28, 0, 0, 17, 45
"/home/eli/Stakken/src/Gameplay/Game.h", "C++", 18, 0, 3, 11, 32
"/home/eli/Stakken/src/Gameplay/Piece.cpp", "C++", 22, 0, 0, 9, 31
"/home/eli/Stakken/src/Gameplay/Piece.h", "C++", 24, 0, 0, 7, 31
"/home/eli/Stakken/src/Gameplay/PieceDefinitions.h", "C++", 236, 0, 0, 63, 299
"/home/eli/Stakken/src/Gameplay/RenderGame.cpp", "C++", 26, 0, 2, 7, 35
"/home/eli/Stakken/src/Gameplay/RenderGame.h", "C++", 6, 0, 0, 3, 9
"/home/eli/Stakken/src/Gameplay/Tile.h", "C++", 21, 0, 0, 2, 23
"/home/eli/Stakken/src/Main.cpp", "C++", 6, 0, 0, 2, 8
"/home/eli/Stakken/src/Systems/Assets/BGShader.cpp", "C++", 63, 0, 4, 21, 88
"/home/eli/Stakken/src/Systems/Assets/BGShader.h", "C++", 13, 0, 0, 3, 16
"/home/eli/Stakken/src/Systems/Assets/Sound.cpp", "C++", 15, 0, 0, 5, 20
"/home/eli/Stakken/src/Systems/Assets/Sound.h", "C++", 9, 0, 0, 3, 12
"/home/eli/Stakken/src/Systems/Assets/Texture.cpp", "C++", 24, 0, 3, 7, 34
"/home/eli/Stakken/src/Systems/Assets/Texture.h", "C++", 9, 0, 0, 2, 11
"/home/eli/Stakken/src/Systems/Identity.h", "C++", 18, 0, 0, 2, 20
"/home/eli/Stakken/src/Systems/Input/InputBuffer.h", "C++", 18, 0, 1, 5, 24
"/home/eli/Stakken/src/Systems/Input/InputProfile.h", "C++", 74, 0, 5, 20, 99
"/home/eli/Stakken/src/Systems/Input/KeyboardMapper.h", "C++", 74, 0, 5, 20, 99
"/home/eli/Stakken/src/Systems/Rendering/Renderer.cpp", "C++", 278, 0, 82, 75, 435
"/home/eli/Stakken/src/Systems/Rendering/Renderer.h", "C++", 18, 0, 2, 8, 28
"/home/eli/Stakken/src/Systems/Rendering/ScreenQuad.cpp", "C++", 28, 0, 0, 10, 38
"/home/eli/Stakken/src/Systems/Rendering/ScreenQuad.h", "C++", 5, 0, 0, 0, 5
"/home/eli/Stakken/src/Systems/Rendering/Shader.cpp", "C++", 90, 0, 2, 27, 119
"/home/eli/Stakken/src/Systems/Rendering/Shader.h", "C++", 16, 0, 0, 4, 20
"/home/eli/Stakken/src/Systems/Rendering/gl3w.c", "C", 0, 784, 27, 37, 848
"/home/eli/Stakken/src/Systems/Rendering/layout.h", "C++", 19, 0, 0, 10, 29
"/home/eli/Stakken/src/Systems/TetrisAction.h", "C++", 23, 0, 1, 2, 26
"Total", "-", 1413, 784, 161, 475, 2833